███████████████████
█     █        █  █
█  ███████  █  █  █
█  █     █  █     █
█  █  █  ███████  █
█  █  █           █
█  █  ███████  █  █
█  █        █  █  █
█  ███████  █  █  █
█     █     █  █  █
███   █   ███  █  █
█ @       █       █
███████████████████